....................
....................
....................
....................
....................
....................
....................
.........GGG........
.........###........
..........#.........
....GGG...#...GGG...
....###...#...###...
..........#.........
.1........#..A....X.
####################
