....................
....................
.......B..X.........
.......######.......
..G..............G..
####..G.G.G.G....###
.......G.G.GBG......
......--------......
...--...........--..
....................
.G.G............G.G.
####............####
....................
.1...........B......
####################
