....................
...G...........BX...
...--..G.......--...
....G.--........G...
...--..........--...
...G......G....G....
...--....--....--...
...BG...........G...
...--........G.--...
...G........--.G....
...--..........--...
....G...........G...
...--..........--...
.1..........B.......
####################
